XXXXXXXXXXXXXXXXXXXX
XOOOOOOOOOXOOOOOOOOX
XOOOOOOOOOXOOOOOOOOX
XXXOXXXXXXXOOOOOOOOX
XOOOOXOOOOOOOOOOOOOX
XOOOOOOOOOOOOXOOOOOX
XOOOOOOOOOOOOXOOOOOX
XOOOOOOOOXXXXXXXXXOX
XOOXOOOOOOOOOXOOOOOX
XOOXOOOXOOOOOOOOOOOX
XOOXOOOXOOOOOOOOOOOX
XXXXXXXXXXXXXXXXXXXX
