XXXXXXXXXXXXOXXXXXXX
XOOOOOOOOOXOOOOOOOOX
XOOOOOOOOOXOOOOOOOOX
XXXOXXXXXXXOOOOOOOOX
XOOOOXOOOOOOOOOOOOOX
XOOOOOOOOOOOOXOOOOOX
OOOOOOOOOOOOOXOOOOOO
XOOOOOOOOXXXXXXXXXOX
XOOXOOOOOOOOOXOOOOOX
XOOXOOOXOOOOOOOOOOOX
XOOXOOOXOOOOOOOOOOOX
XXXXXXXXXXOXXXXXXXXX
