XXXXXXXXXXXXOXXXXXXX
XOOOOOOOOOXOOOOOOOOX
XOOOOOOOOOXOOOOOOOOX
XXXOXXXXXXXOOOOOOOOX
XOOOOXOOOOOOOOOOOOOX
XOOOOOOOOOOOOOvOOvOX
OOOOOOOOOOOOOOOOOOOO
XOOOOOOOOXXXXXVXXVOX
XOOOOOOOOOOOOXOOOOOX
XOOOOOOXOOOOOOOOOOOX
XOOOOOOXOOOOOOOOOOOX
XXXXXXXXXYYYXXXXXXXX
