oooooooooooooooooooooooooooooooooooooooooooooooooooooooooooooooooooooooooooooooooooooooooooooooooooooooooooooooooooooooo
oOOOOOOOOOOOOOOOOOOOOOOOOOOOOOOOOOOOOOOOOOOOOOOOOOOOOOOOOOOOOOOOOOOOOOOOOOOOOOOOOOOOOOOOOOOOOOOOOOOOOOOOOOOOOOOOOOOOOOOo
oOOOOOOOOOOOOOOOOOOOOOOOOOOOOOOOOOOOOOOOOOOOOOOOOOOOOOOOOOOOOOOOOOOOOOOOOOOOOOOOOOOOOOOOOOOOOOOOOOOOOOOOOOOOOOOOOOOOOOOo
oOOOOOOOOOOOOOOOOOOOOOOOOOOOOOOOOOOOOOOOOOOOOOOOOOOOOOOOOOOOOOOOOOOOOOOOOOOOOOOOOOOOOOOOOOOOOOOOOOOOOOOOOOOOOOOOOOOOOOOo
oOOOOOOOOOOOOOOOOOOOOOOOOOOOOOOOOOOOOOOOOOOOOOOOOOOOOOOOOOOOOOOOOOOOOOOOOOOOOOOOOOOOOOOOOOOOOOOOOOOOOOOOOOOOOOOOOOOOOOOo
oOOOOOOOOOOOOOOOOOOOOOOOOOOOOOOOOOOOOOOOOOOOOOOOOOOOOOOOOOOOOOOOOOOOOOOOOOOOOOOOOOOOOOOOOOOOOOOOOOOOOOOOOOOOOOOOOOOOOOOo
oOOOOOOOOOOOOOOOOOOOOOOOOOOOOOOOOOOOOOOOOOOOOOOOOOOOOOOOOOOOOOOOOOOOOOOOOOOOOOOOOOOOOOOOOOOOOOOOOOOOOOOOOOOOOOOOOOOOOOOo
oOOOOOOOOOOOOOOOOOOOOOOOOOOOOOOOOOOOOOOOOOOOOOOOUOOOOOOOOOOOOOOOOOOOUOOOOOOOOOOOOOOOOOOOOOOOOUOOOOOOOOOOOOOOOOOOOOOOOOOo
oOOOOOOOOOOOOOOOOOOOOOOOOOOOOOOOOOOOOOOOOOOOOOOOOOOOOOOOOOOOOOOOOOOOOOOOOOOOOOOOOOOOOOOOOOOOOOOOOOOOOOOOOOOOOOOOOOOOOOOo
oOOOOOOOOOOOOOvOOvOOOOOOOOOOOeFFFEOOOOOOOOOOOOOOOOvOOvOOOOOOOOOOOOOOOOOOOOOOOOOOObOOSOOOOOeFFFOOOOOOOOvOOvOOvOOvOOvOOOOo
obO231OTOOOBOOOObOOOSO3bOOBOOOfffeFFFEb1O32OBOOtOOOOOOOOSOBeFFFE0b024OOOOBOTO1eFFFFFFFEOTOOfffOOOOOOSOOOOOObOO32OOOOOSOo
XXXXXXXXXXXXXXVXXVXXXXXXXXXXXXXXXXXXXXXXXXXXXXXXXYyYYyYXXXXXXXXXXXXXXYYYXXXXXXXXXXXXXXXXXXXXXXYYYYXXXXVXXVXXVXXVXXVXXXXX