XXXXXXXXXXXXXXXXXXXX
XOOOOOOOOOXOOOOOOOOX
XOOOOOOOOOXOOOOOOOOX
XOOOXXXXXXXOOOOOOOOX
XOOOOXOOOOOOOOOOOOOX
XOOOOOOOOOOOOXOOOOOX
XOOOOOOOOOOOOXOOOOOX
XOOOOOOOOXXXXXXOOOOX
XOOXOOOOOOOOOXOOOOOX
XOOXOOOXOOOOOOOOOOOX
XOOXOOOXOOOOOOOOOOOX
XXXXXXXXXXXXXXXXXXXX