oooooooooooooooooooooooooooooooooooooooooooooooooooooooooooooooooooooooooooooooooooooooooooooooooooooooooooooooooooooooo
oOOOOOOOOOOOOOOOOOOOOOOOOOOOOOOOOOOOOOOOOOOOOOOOOOOOOOOOOOOOOOOOOOOOOOOOOOOOOOOOOOOOOOOOOOOOOOOOOOOOOOOOOOOOOOOOOOOOOOOo
oOOOOOOOOOOOOOOOOOOOOOOOOOOOOOOOOOOOOOOOOOOOOOOOOOOOOOOOOOOOOOOOOOOOOOOOOOOOOOOOOOOOOOOOOOOOOOOOOOOOOOOOOOOOOOOOOOOOOOOo
oOOOOOOOoOOOOoOOOOOOOOOOOOOOOOOOOOOOOOOOOOOOOOOOOOOOOOOOOOOOOOOOOOOOOOOOOOOOOOOOOOOOOOOOOOOOOOOOOOOOOOOOOOOOOOOOOOOOOOOo
oOOOOOOOoOOOOoOOOOOOOOOOOOOOOOOOOOOOOOOOOOOOOOOOOOOOOOOOOOOOOOOOOOOOOOOOOOOOOOOOOOOOOOOOOOOOOOOOOOOOOOOOOOOOOOOOOOOOOOOo
oOOOOOOOoOOOOoOOOOOOOOOOOOOOOOOOOOOOOOOOOOOOOOOOOOOOOOOOOOOOOOOOOOOOOOOOOOOOOOOOOOOOOOOOOOOOOOOOOOOOOOOOOOOOOOOOOOOOOOOo
oOOOOOOOoOOOOoOOOOOOOOOOOOOOOOOOOOOOOOOOOOOOOOOOOOOOOOOOOOOOOOOOOOOOOOOOOOOOOOOOOOOOOOOOOOOOOOOOOOOOOOOOOOOOOOOOOOOOOOOo
oOOOOOOOoOOOOoOOOOOOOOOOOOOOOOOOOOOOOOOOOOOOOOOOUOOOOOOOOOOOOOOOOOOOUOOOOOOOOOOOOOOOOOOOOOOOOUOOOOOOOOOOOOOOOOOOOOOOOOOo
oOOOOOOOoOOOOoOOOOOOOOOOOOOOOOOOOOOOOOOOOOOOOOOOOOOOOOOOOOOOOOOOOOOOOOOOOOOOOOOOOOOOOOOOOOOOOOOOOOOOOOOOOOOOOOOOOOOOOOOo
oOOOOOOOoOOOOovOOvOOOOOOOOOOOeFFFEOOOOOOOOOOOOOOOOvOOvOOOOOOOOOOOOOOOOOOOOOOOOOOObOOSOOOOOeFFFOOOOOOOOvOOvOOvOOvOOvOOOOo
obO231OToOOBOoOObOOOSO3bOOBOOOfffeFFFEb1O32OBOOtOOOOOOOOSOBeFFFE0b024OOOOBOTO1eFFFFFFFEOTOOfffOOOOOOSOOOOOObOO32OOOOOSOo
XXXXXXXXXXXXXXVXXVXXXXXXXXXXXXXXXXXXXXXXXXXXXXXXXYyYYyYXXXXXXXXXXXXXXYYYXXXXXXXXXXXXXXXXXXXXXXYYYYXXXXVXXVXXVXXVXXVXXXXX